1111111111111
1000001111001
10010000100C1
1P0011E001001
1001000000001
1000100000001
1C00001000001
100C010000001
1000000000001
10000C001C001
1C00100000001
1111111111111
