111111111111111111111
1000000C0000CC0000111
100E00000000000000011
10000000000000C000001
111111111111111111111
