11111111111111111111111111111
1000000000000000CC10000000001
1000C000000111110001CC0000E01
1000000000000001CC10000000001
10000C111C0000011111000000011
1000000000000001CCC1000011111
11100010000011011000000000001
11111110001C10001CCC101C10001
1000000010011000011110001C111
1000001C100000001111000001111
1110001C100011110000001111111
1110001CC100000000C0001011111
1000001110001CC101110000000C1
11110011110000CCCC000011111C1
1P0000000000000111111C1111111
11111111111111111111111111111
